1111111111111111111111111111111111
1C00000000000000000000000000000001
1111111111111111111111111111111101
1E00C00000C00000000000000000000001
1010010100100000101001000P00010101
1010010010101010001001000000010101
10000000000000000000000000C0000001
1111111111111111111111111111111111
