1111111111111111111111111111111111
1C10000000000000000000000000000001
1110111111111111111111111111111111
1E10C00000C00000000000000000000001
1110010100100000101001000P00010101
1010010010101010001001000000010101
10000000000000000000000100C0000001
1111111111111111111111111111111111
